Symphony No. 9 (Scherzo)
#1 Soprano Album [Disc 2]	Orff: Carmina Burana - 21. Cour D'Amours: In Trutina
1967-1970 [Disc 1]	Strawberry Fields Forever
1967-1970 [Disc 2]	Back In The USSR
20th Century Masters: The Best Of The Who	My Generation
30 Greatest Summer Hits	Soak Up The Sun
30 Greatest Summer Hits [Disc 2]	I Can See Clearly Now
36 All -Time Greatest Hits [Disc 3]	Non Dimenticar
36 All-Time Greatest Hits	There Goes My Heart
36 All-Time Greatest Hits [Disc 1]	I'm In The Mood For Love
50 Golden Hymns - Volume 1 - Great Is Thy Faithfulness	Great Is Thy Faithfulness
50 Golden Hymns Instrumental Collection Vol.1	Blessed Assurance
50 Golden Hymns [Vol. 3 - How Great Thou Art]	Come Thou Almighty King
A Christmas Album	Go Tell It On The Mountain
A Quiet Christmas	Good Christian Men Rejoice
Afterglow	Fallen
All Day, All Night	G.H.E.T.T.O.U.T.
Andalusian Nights	Andalusian Nights
Bach: Cello Suites (1 of 2)	Unaccompanied Cello Suite No.1 In G Major, BWV.1007 1. Praeludium
Bach: Cello Suites (2 of 2)	Suite for solo cello No. 4 in E flat major, BWV 1010: Prelude
Bad, Bad Leroy Brown & Other Favorites	Bad, Bad Leroy Brown
Bare	A Thousand Beautiful Things
Beethoven: Violin Concerto, Romances	Beethoven: Violin Concerto In D, Op. 61 - 1. Allegro Ma Mon Troppo
Believe	The Power
Billy Copland	sndrec
Bing Crosby/Rosemary Clooney & Friends	Have Yourself a Merry Christmas
Blues Brothers 2000	Born In Chicago
Body Language	Are U Ready?
Breathless	The Joy Of Life
Carry On [Disc 2]	Dear Mr. Fantasy
Christmas Carols	Gates Christmas Blues
Christmas Extravaganza	Here We Come A' Wassailing
Christmas Memories	A Christmas Love Song
Christmas Portrait	Overture
Design Of A Decade: 1986-1996	Runaway
Drag	Don't Smoke In Bed
EV3	Whatever
Experience The Divine: Greatest Hits	Hello In There
Fiesta del Sol	Fiesta del Sol
Garth Brooks & The Magic Of Christmas	It's The Most Wonderful Time Of The Year
Greatest Hits	Wild World
Guitar Odyssey	Magellan's Beat
Handel: Messiah [Disc 1]	Handel: Messiah, HWV 56 - Overture
Handel: Messiah [Disc 2]	Handel: Messiah, HWV 56 - He Was Despised
Harry For the Holidays	Frosty The Snow Man
Heart Shaped World	Heart Shaped World
Home And Hearth	Suzy Snowflake
Hope Floats	What Makes You Stay
Hymns Just For You	It Is Well With My Soul
If We Fall In Love Tonight	If We Fall In Love Tonight
II	All Around The World
Indians, Songs, Nature, Dreams	Dream Catchers
Inside Job	Nobody Else In The World But You
Instrumental Praise Series: Great Is The Lord	Shine, Jesus, Shine [Instrumental]
Jazz For When You're Alone	That's All There is to Love
JEKYLL + HYDE	I'll Be Your Man (Song for a Daughter)
Just For You - Live In Concert	Just For You
Kiss Me [Single]	Kiss Me (Radio Remix)
Kreisler: Original Compositions & Arrangements	Kreisler: Caprice Viennois, Op. 2
Land Of The Loon	Returning Home
Left Of The Middle	Torn
Let's Talk About Love	The Reason
Little Wing	Agua Fria (Cold Water)
Moonlight & Sax: Passionate Saxophone and Soulful Strings	Smoke Gets In Your Eyes
More Than A Woman	Let Me Show You The Way (Out)
Mozart; Mendelssohn: Violin Concertos (1934-1949)	Mozart: Violin Concerto #5, A, K 219 - Allegro Aperto
Nude on the Moon: The B-52's Anthology (Phase 2)	Summer Of Love
Nude On The Moon: The B-52's Anthology [Disc 1]	52 Girls
Only A Woman Like You	I Wanna Hear You Say It
Pacific Grace	Pacific Grace
Pieces Of You	Who Will Save Your Soul
Practical Magic Soundtrack	Practical Magic
Rare Rock Tracks	Cold Irons Bound
Rat Pack: Members Edition [Live]	I Left My Heart In San Francisco
Ray Of Light	Drowned World/Substitute For Love
Ricky Martin	Livin' La Vida Loca
Ride	Grand Central
Romancing The Sax	When I Fall In Love
Seduction	Camouflage
Sevens	Longneck Bottle
Shake It Up	R.S.V.P.
Sharing The Holidays With Nat King Cole And Friends	O Tannenbaum (Oh Christmas Tree)
Sheryl Crow	Maybe Angels
Shine	Shine (Featuring Esthero)
Sinatra Reprise: The Very Good Years	The Last Dance
Sleep: Music for Deep Relaxation	On The Wings Of A Tern
Smooth	Don't Worry About It
Soul Of The East	Mecca Interlude
Soulful Christmas	Merry Christmas All
Still Waters	Alone
Surfacing	Building A Mystery
Tea For Two-On Moonlight Bay-My Dream is Yours	Crazy Rhythm
The # 1 Soprano Album	"Che soave zeffiretto" - "Piegato Ã¨ il foglio..."
The Bedroom Tapes	Our Affair
The Best Of (37 All-Time Favorites) Vol 2	You Wear It Well
The Best Of (37 All-Time Favorites) Vol 3	(You Make Me Feel Like) A Natural Man
The Best Of Al Stewart	Time Passages
The Best Of Don McLean	Vincent
The Best Of Rod Stewart: 37 All-Time Favorites [Disc 1]	Maggie May
The Best Of Santana	Black Magic Woman [Gypsy Queen]
The Best Of The Capitol Years	I've Got The World On A String
The Best That I Could Do	I Need A Lover
The Christmas Present	O Come, O Come Emmanuel
The Essential Simon & Garfunkel [Disc 1]	Wednesday Morning, 3 A.M. [Live]
The Essential Simon & Garfunkel [Disc 2]	Mrs. Robinson
The Essentials	Taxi
The Official Album	Fantasyland Castle Medley
The Other Side	When Love Starts Talkin'
The Very Best Of Cher	If I Could Turn Back Time
The Very Best Of Louis Armstrong	Hello Dolly
The Very Best Of The Doors	Roadhouse Blues [Live]
This Is Where I Came In	This Is Where I Came In
Time Pieces: The Best Of Eric Clapton	I Shot The Sheriff
Up! [Red Disc]	Up!
Very Best Of Peggy Lee	Elmer's Tune
Volume 11 - Peace	Jesus Paid It All
Volume 12 - Renewal	O Come Let Us Adore Him
White Christmas Digial LaserLight	Silent Night, Holy Night
White Chritmas	I'll Be Home For Christmas (If Only In My Dreams)
Whoa, Nelly!	Hey, Man!
Winter Light	Forgotten Yesterdays
Your Lingering Touch	Tears Of Joy
